Localidades,Pop ,Pop Masc,Pop Fem ,Pop Urbana ,Pop Rural ,Grau Urban(porc)
Adamantina,33894,16326,17568,32668,1226,96.38
Adolfo,3447,1707,1740,3189,258,92.52
Aguaí,35608,17889,17719,32833,2775,92.21
Águas da Prata,7797,3830,3967,7188,609,92.19
Águas de Lindóia,18374,8944,9430,18209,165,99.1
Águas de Santa Bárbara,5931,2903,3028,4611,1320,77.74
Águas de São Pedro,3122,1466,1656,3122,,100
Agudos,36134,17816,18318,34815,1319,96.35
Alambari,5779,2885,2894,4729,1050,81.83
Alfredo Marcondes,3927,2001,1926,3554,373,90.5
Altair,4036,2142,1894,3413,623,84.56
Altinópolis,15553,7735,7818,14272,1281,91.76
Alto Alegre,4017,2052,1965,3412,605,84.94
Alumínio,17972,9023,8949,15073,2899,83.87
Álvares Florence,3621,1832,1789,2663,958,73.54
Álvares Machado,23789,11684,12105,21720,2069,91.3
Álvaro de Carvalho,5044,3142,1902,3400,1644,67.41
Alvinlândia,3176,1566,1610,2929,247,92.22
Americana,233458,114164,119294,232367,1091,99.53
Américo Brasiliense,40243,20106,20137,39938,305,99.24
Américo de Campos,5736,2865,2871,5025,711,87.6
Amparo,69639,34189,35450,58620,11019,84.18
Analândia,4850,2475,2375,4065,785,83.81
Andradina,56054,27443,28611,52856,3198,94.29
Angatuba,24501,12302,12199,18333,6168,74.83
Anhembi,6672,3398,3274,5256,1416,78.78
Anhumas,3963,1971,1992,3477,486,87.74
Aparecida,35709,17187,18522,35190,519,98.55
Aparecida d'Oeste,4132,2001,2131,3589,543,86.86
Apiaí,24666,12298,12368,19995,4671,81.06
Aramina,5496,2741,2755,5293,203,96.31
Arandu,6165,3099,3066,5087,1078,82.51
Arapeí,2471,1234,1237,1920,551,77.7
Araraquara,227618,109815,117803,221147,6471,97.16
Araras,131057,64375,66682,124772,6285,95.2
Araçariguama,20980,10611,10369,20980,,100
Araçatuba,190469,91360,99109,186796,3673,98.07
Araçoiaba da Serra,32390,16012,16378,22263,10127,68.73
ArcoÍris,1816,906,910,1165,651,64.15
Arealva,8196,4121,4075,6875,1321,83.88
Areias,3843,1901,1942,2577,1266,67.06
Areiópolis,10857,5558,5299,10062,795,92.68
Ariranha,9320,4714,4606,8826,494,94.7
Artur Nogueira,52609,26120,26489,47632,4977,90.54
Arujá,89744,44246,45498,86429,3315,96.31
Aspásia,1765,882,883,1322,443,74.9
Assis,101381,49365,52016,96956,4425,95.64
Atibaia,139606,68437,71169,130756,8850,93.66
Auriflama,14471,7181,7290,13517,954,93.41
Avaí,5288,2643,2645,3551,1737,67.15
Avanhandava,12114,6637,5477,10243,1871,84.56
Avaré,87538,43336,44202,84509,3029,96.54
Bady Bassitt,16329,8109,8220,15333,996,93.9
Balbinos,3704,2978,726,1191,2513,32.15
Bálsamo,8524,4150,4374,7948,576,93.24
Bananal,10651,5251,5400,8994,1657,84.44
Barão de Antonina,3383,1710,1673,2156,1227,63.73
Barbosa,7284,3651,3633,6230,1054,85.53
Bariri,33993,16944,17049,32762,1231,96.38
Barra Bonita,34914,17011,17903,34268,646,98.15
Barra do Chapéu,5530,2886,2644,1628,3902,29.44
Barra do Turvo,7687,3971,3716,3591,4096,46.72
Barretos,118048,57086,60962,114452,3596,96.95
Barrinha,32338,16190,16148,31979,359,98.89
Barueri,264390,128627,135763,264390,,100
Bastos,20301,9916,10385,18001,2300,88.67
Batatais,60222,29529,30693,53258,6964,88.44
Bauru,364225,176473,187752,358133,6092,98.33
Bebedouro,74155,36025,38130,71307,2848,96.16
Bento de Abreu,2945,1489,1456,2815,130,95.59
Bernardino de Campos,10787,5243,5544,9869,918,91.49
Bertioga,63290,31408,31882,62695,595,99.06
Bilac,7816,3849,3967,7373,443,94.33
Birigui,121329,58965,62364,118125,3204,97.36
Biritiba Mirim,32338,16227,16111,28210,4128,87.23
Boa Esperança do Sul,14582,7283,7299,13403,1179,91.91
Bocaina,12135,6022,6113,11341,794,93.46
Bofete,11076,5568,5508,7062,4014,63.76
Boituva,57292,28670,28622,53893,3399,94.07
Bom Jesus dos Perdões,24291,12127,12164,22118,2173,91.05
Bom Sucesso de Itararé,3861,1944,1917,2885,976,74.72
Borá,812,422,390,632,180,77.83
Boracéia,4759,2417,2342,4342,417,91.24
Borborema,15323,7707,7616,14405,918,94.01
Borebi,2579,1272,1307,2400,179,93.06
Botucatu,141135,68579,72556,136396,4739,96.64
Bragança Paulista,163980,80417,83563,160871,3109,98.1
Braúna,5552,2786,2766,5150,402,92.76
Brejo Alegre,2768,1408,1360,2378,390,85.91
Brodowski,23943,11785,12158,23647,296,98.76
Brotas,23850,11820,12030,20735,3115,86.94
Buri,19678,9979,9699,16462,3216,83.66
Buritama,16596,8263,8333,15922,674,95.94
Buritizal,4307,2191,2116,3611,696,83.84
Cabrália Paulista,4308,2177,2131,3760,548,87.28
Cabreúva,49430,24837,24593,44288,5142,89.6
Cachoeira Paulista,32231,15736,16495,26907,5324,83.48
Caconde,18854,9370,9484,13537,5317,71.8
Cafelândia,17244,8485,8759,15529,1715,90.05
Caiabu,4103,2103,2000,3506,597,85.45
Caieiras,100612,49282,51330,98864,1748,98.26
Caiuá,5600,2893,2707,2145,3455,38.3
Cajamar,77627,38646,38981,76714,913,98.82
Cajati,28992,14590,14402,21499,7493,74.15
Cajobi,10105,5137,4968,9594,511,94.94
Cajuru,25663,12784,12879,22937,2726,89.38
Campina do Monte Alegre,5812,2929,2883,5120,692,88.09
Campinas,1175501,567233,608268,1155288,20213,98.28
Campo Limpo Paulista,82842,40611,42231,82842,,100
Campos do Jordão,50118,24371,25747,49805,313,99.38
Campos Novos Paulista,4817,2464,2353,3981,836,82.64
Cananéia,12341,6144,6197,10710,1631,86.78
Canas,5064,2543,2521,4870,194,96.17
Cândido Mota,30019,14693,15326,28537,1482,95.06
Cândido Rodrigues,2674,1306,1368,2286,388,85.49
Canitar,4991,2516,2475,4766,225,95.49
Capão Bonito,46418,23054,23364,39459,6959,85.01
Capela do Alto,20542,10517,10025,17817,2725,86.73
Capivari,54231,27079,27152,52908,1323,97.56
Caraguatatuba,116106,56984,59122,111793,4313,96.29
Carapicuíba,394598,191655,202943,394598,,100
Cardoso,11721,5736,5985,10781,940,91.98
Casa Branca,29462,15444,14018,24404,5058,82.83
Cássia dos Coqueiros,2495,1266,1229,1916,579,76.79
Castilho,20728,10256,10472,15642,5086,75.46
Catanduva,117206,56874,60332,116265,941,99.2
Catiguá,7529,3802,3727,7010,519,93.11
Caçapava,91217,45040,46177,78049,13168,85.56
Cedral,8836,4384,4452,7326,1510,82.91
Cerqueira César,19213,9455,9758,17718,1495,92.22
Cerquilho,46411,22942,23469,44009,2402,94.82
Cesário Lange,17248,8905,8343,11645,5603,67.52
Charqueada,16933,8574,8359,15491,1442,91.48
Chavantes,12223,6055,6168,11525,698,94.29
Clementina,8324,4293,4031,8066,258,96.9
Colina,17603,8660,8943,16781,822,95.33
Colômbia,6046,3052,2994,4541,1505,75.11
Conchal,27284,13716,13568,26382,902,96.69
Conchas,17134,8552,8582,14628,2506,85.37
Cordeirópolis,24356,12216,12140,21876,2480,89.82
Coroados,5926,2940,2986,5081,845,85.74
Coronel Macedo,4843,2463,2380,3969,874,81.95
Corumbataí,3962,1991,1971,2475,1487,62.47
Cosmópolis,71282,35411,35871,66201,5081,92.87
Cosmorama,6997,3489,3508,5364,1633,76.66
Cotia,247424,121053,126371,247424,,100
Cravinhos,34428,17154,17274,33919,509,98.52
Cristais Paulista,8425,4265,4160,6987,1438,82.93
Cruzália,2117,1023,1094,1508,609,71.23
Cruzeiro,79927,38818,41109,78112,1815,97.73
Cubatão,129145,64116,65029,129145,,100
Cunha,21681,10990,10691,13609,8072,62.77
Descalvado,32430,15933,16497,30064,2366,92.7
Diadema,404477,195649,208828,404477,,100
Dirce Reis,1717,868,849,1417,300,82.53
Divinolândia,10886,5364,5522,8192,2694,75.25
Dobrada,8904,4569,4335,8705,199,97.77
Dois Córregos,26972,13477,13495,26113,859,96.82
Dolcinópolis,2040,1056,984,1915,125,93.87
Dourado,8482,4261,4221,7778,704,91.7
Dracena,44995,22124,22871,41798,3197,92.89
Duartina,11975,5788,6187,11044,931,92.23
Dumont,9570,4779,4791,9392,178,98.14
Echaporã,6217,3048,3169,5145,1072,82.76
Eldorado,15236,7693,7543,7498,7738,49.21
Elias Fausto,17346,8921,8425,14606,2740,84.2
Elisiário,3499,1817,1682,3267,232,93.37
Embaúba,2409,1246,1163,2139,270,88.79
Embu das Artes,270790,131608,139182,270790,,100
Embu-Guaçu,68053,33656,34397,66238,1815,97.33
Emilianópolis,3068,1534,1534,2692,376,87.74
Engenheiro Coelho,20535,10661,9874,15639,4896,76.16
Espírito Santo do Pinhal,42573,20804,21769,38837,3736,91.22
Espírito Santo do Turvo,4799,2395,2404,4105,694,85.54
Estiva Gerbi,11079,5523,5556,8837,2242,79.76
Estrela d'Oeste,8094,4056,4038,7059,1035,87.21
Estrela do Norte,2665,1357,1308,2307,358,86.57
Euclides da Cunha Paulista,9537,4753,4784,6155,3382,64.54
Fartura,15644,7550,8094,13045,2599,83.39
Fernando Prestes,5572,2716,2856,5043,529,90.51
Fernandópolis,66112,32060,34052,64087,2025,96.94
Fernão,1649,828,821,1009,640,61.19
Ferraz de Vasconcelos,193037,94280,98757,184375,8662,95.51
Flora Rica,1589,787,802,1386,203,87.22
Floreal,2856,1401,1455,2420,436,84.73
Flórida Paulista,12120,6637,5483,9563,2557,78.9
Florínea,2703,1307,1396,2475,228,91.56
Franca,342125,167238,174887,336119,6006,98.24
Francisco Morato,174403,86341,88062,174048,355,99.8
Franco da Rocha,152201,77456,74745,140219,11982,92.13
Gabriel Monteiro,2684,1344,1340,2386,298,88.9
Gália,6563,3248,3315,5089,1474,77.54
Garça,42483,20622,21861,39806,2677,93.7
Gastão Vidigal,4768,2588,2180,4473,295,93.81
Gavião Peixoto,4610,2362,2248,4116,494,89.28
General Salgado,10648,5286,5362,9424,1224,88.5
Getulina,10847,5887,4960,8841,2006,81.51
Glicério,4749,2361,2388,3659,1090,77.05
Guaimbê,5534,2735,2799,5045,489,91.16
Guaíra,39061,19247,19814,37840,1221,96.87
Guaiçara,11947,5981,5966,11131,816,93.17
Guapiara,17775,8983,8792,7499,10276,42.19
Guapiaçu,20848,10482,10366,18942,1906,90.86
Guará,20824,10335,10489,20329,495,97.62
Guaraci,10978,5565,5413,10201,777,92.92
Guarani d'Oeste,1922,939,983,1718,204,89.39
Guarantã,6477,3243,3234,5882,595,90.81
Guararapes,32076,15724,16352,30158,1918,94.02
Guararema,29429,14694,14735,25325,4104,86.05
Guaratinguetá,118345,56915,61430,112868,5477,95.37
Guaraçaí,8412,4140,4272,6910,1502,82.14
Guareí,15750,9448,6302,9097,6653,57.76
Guariba,39021,19563,19458,38406,615,98.42
Guarujá,316405,154134,162271,316344,61,99.98
Guarulhos,1351275,658363,692912,1351275,,100
Guatapará,7440,3787,3653,5982,1458,80.4
Guzolândia,5107,2579,2528,4550,557,89.09
Herculândia,9260,4621,4639,8671,589,93.64
Holambra,14493,7329,7164,12287,2206,84.78
Hortolândia,230268,115703,114565,230268,,100
Iacanga,11306,5782,5524,10025,1281,88.67
Iacri,6272,3168,3104,5299,973,84.49
Iaras,6894,4434,2460,3067,3827,44.49
Ibaté,34738,17709,17029,33550,1188,96.58
Ibirá,12059,5963,6096,11269,790,93.45
Ibirarema,7509,3759,3750,7054,455,93.94
Ibitinga,58501,28760,29741,56607,1894,96.76
Ibiúna,76430,38520,37910,28199,48231,36.9
Icém,8032,4075,3957,6963,1069,86.69
Iepê,7921,3887,4034,7354,567,92.84
Igarapava,29456,14549,14907,28119,1337,95.46
Igaratá,9312,4729,4583,7971,1341,85.6
Igaraçu do Tietê,24135,11976,12159,23997,138,99.43
Iguape,29465,14632,14833,25834,3631,87.68
Ilha Comprida,10296,5009,5287,10296,,100
Ilha Solteira,25748,12426,13322,24162,1586,93.84
Ilhabela,33470,16864,16606,33240,230,99.31
Indaiatuba,242868,120227,122641,240426,2442,98.99
Indiana,4775,2388,2387,4209,566,88.15
Indiaporã,3854,1867,1987,3491,363,90.58
Inúbia Paulista,3892,1938,1954,3527,365,90.62
Ipaussu,14506,7278,7228,13644,862,94.06
Iperó,34352,18176,16176,21197,13155,61.71
Ipeúna,7571,3879,3692,6860,711,90.61
Ipiguá,5231,2631,2600,3383,1848,64.67
Iporanga,4407,2206,2201,2894,1513,65.67
Ipuã,15861,8022,7839,15355,506,96.81
Iracemápolis,23654,11787,11867,23238,416,98.24
Irapuã,7734,4010,3724,7132,602,92.22
Irapuru,7334,4255,3079,5185,2149,70.7
Itaberá,17614,8836,8778,13379,4235,75.96
Itaí,26507,13928,12579,20814,5693,78.52
Itajobi,14614,7308,7306,12840,1774,87.86
Itaju,3654,1891,1763,2959,695,80.98
Itanhaém,98757,47554,51203,98018,739,99.25
Itaoca,3186,1652,1534,1737,1449,54.52
Itapecerica da Serra,169619,84582,85037,168213,1406,99.17
Itapetininga,160150,79719,80431,147379,12771,92.03
Itapeva,91693,45170,46523,83413,8280,90.97
Itapevi,237714,116910,120804,237714,,100
Itapira,71500,35231,36269,67027,4473,93.74
Itapirapuã Paulista,4180,2124,2056,2146,2034,51.34
Itápolis,41548,20493,21055,38966,2582,93.79
Itaporanga,14688,7300,7388,11952,2736,81.37
Itapuí,13779,6904,6875,13369,410,97.02
Itapura,4916,2510,2406,3929,987,79.92
Itaquaquecetuba,370589,182254,188335,370589,,100
Itararé,49018,24010,25008,45460,3558,92.74
Itariri,17274,8637,8637,12323,4951,71.34
Itatiba,117916,58013,59903,102739,15177,87.13
Itatinga,20550,10443,10107,19190,1360,93.38
Itirapina,17162,9962,7200,15873,1289,92.49
Itirapuã,6279,3169,3110,5425,854,86.4
Itobi,7609,3891,3718,7157,452,94.06
Itu,169772,83649,86123,161437,8335,95.09
Itupeva,59159,29812,29347,55279,3880,93.44
Ituverava,40246,19573,20673,37890,2356,94.15
Jaborandi,6677,3351,3326,6340,337,94.95
Jaboticabal,74221,35999,38222,72946,1275,98.28
Jacareí,227945,111079,116866,224797,3148,98.62
Jaci,6969,3524,3445,6371,598,91.42
Jacupiranga,17222,8719,8503,9377,7845,54.45
Jaguariúna,54848,27057,27791,53844,1004,98.17
Jales,47254,22954,24300,44467,2787,94.1
Jambeiro,6214,3168,3046,2975,3239,47.88
Jandira,123603,60463,63140,123603,,100
Jardinópolis,42893,21450,21443,42070,823,98.08
Jarinu,29820,14848,14972,25692,4128,86.16
Jaú,147505,71960,75545,143891,3614,97.55
Jeriquara,3141,1603,1538,2733,408,87.01
Joanópolis,12666,6336,6330,12666,,100
João Ramalho,4384,2223,2161,3903,481,89.03
José Bonifácio,35981,17873,18108,33223,2758,92.33
Júlio Mesquita,4640,2255,2385,4430,210,95.47
Jumirim,3306,1695,1611,2175,1131,65.79
Jundiaí,407016,198688,208328,395118,11898,97.08
Junqueirópolis,20065,10511,9554,17068,2997,85.06
Juquiá,18828,9408,9420,12310,6518,65.38
Juquitiba,30401,15255,15146,26087,4314,85.81
Lagoinha,4819,2426,2393,3421,1398,70.99
Laranjal Paulista,27834,13687,14147,25207,2627,90.56
Lavínia,8500,5997,2503,4148,4352,48.8
Lavrinhas,7167,3584,3583,6741,426,94.06
Leme,100975,50369,50606,99174,1801,98.22
Lençóis Paulista,66343,32787,33556,65168,1175,98.23
Limeira,296300,145230,151070,289378,6922,97.66
Lindóia,7722,3802,3920,7722,,100
Lins,75087,36425,38662,74209,878,98.83
Lorena,86639,41841,44798,84522,2117,97.56
Lourdes,2182,1132,1050,1870,312,85.7
Louveira,48268,24328,23940,47122,1146,97.63
Lucélia,21019,11029,9990,18381,2638,87.45
Lucianópolis,2261,1115,1146,1843,418,81.51
Luís Antônio,14166,7287,6879,13961,205,98.55
Luiziânia,5754,2970,2784,5441,313,94.56
Lupércio,4421,2140,2281,4196,225,94.91
Lutécia,2621,1297,1324,2197,424,83.82
Macatuba,16932,8465,8467,16559,373,97.8
Macaubal,7749,3881,3868,7028,721,90.7
Macedônia,3574,1771,1803,2844,730,79.57
Magda,3088,1567,1521,2641,447,85.52
Mairinque,46323,22945,23378,37178,9145,80.26
Mairiporã,98622,49481,49141,90911,7711,92.18
Manduri,9525,4721,4804,8786,739,92.24
Marabá Paulista,4931,3084,1847,2195,2736,44.51
Maracaí,13521,6705,6816,12503,1018,92.47
Marapoama,2906,1477,1429,2617,289,90.06
Mariápolis,3975,2027,1948,3406,569,85.69
Marília,231554,111671,119883,221166,10388,95.51
Marinópolis,2097,1058,1039,1728,369,82.4
Martinópolis,25668,13246,12422,22310,3358,86.92
Matão,80020,39430,40590,78552,1468,98.17
Mauá,460132,224753,235379,460132,,100
Mendonça,5043,2538,2505,4386,657,86.97
Meridiano,3739,1805,1934,2709,1030,72.45
Mesópolis,1893,942,951,1635,258,86.37
Miguelópolis,21424,10633,10791,20459,965,95.5
Mineiros do Tietê,12597,6245,6352,12034,563,95.53
Mira Estrela,2939,1446,1493,1960,979,66.69
Miracatu,19934,9901,10033,10767,9167,54.01
Mirandópolis,28646,15534,13112,26161,2485,91.33
Mirante do Paranapanema,17769,8907,8862,10463,7306,58.88
Mirassol,57824,28358,29466,56363,1461,97.47
Mirassolândia,4702,2383,2319,3823,879,81.31
Mococa,66753,33085,33668,63433,3320,95.03
Mogi das Cruzes,432905,210668,222237,401520,31385,92.75
Mogi Guaçu,148325,73207,75118,142302,6023,95.94
Mogi Mirim,90439,44315,46124,86584,3855,95.74
Mombuca,3332,1683,1649,2948,384,88.48
Mongaguá,54610,26995,27615,54372,238,99.56
Monte Alegre do Sul,7749,3863,3886,4827,2922,62.29
Monte Alto,48405,23750,24655,46900,1505,96.89
Monte Aprazível,23458,11561,11897,21781,1677,92.85
Monte Azul Paulista,18191,9037,9154,17350,841,95.38
Monte Castelo,3991,1955,2036,3336,655,83.59
Monte Mor,59614,29636,29978,56936,2678,95.51
Monteiro Lobato,4465,2297,2168,1983,2482,44.41
Monções,2175,1104,1071,1898,277,87.26
Morro Agudo,32332,16421,15911,31558,774,97.61
Morungaba,13247,6601,6646,11938,1309,90.12
Motuca,4638,2327,2311,3705,933,79.88
Murutinga do Sul,4281,2110,2171,2631,1650,61.46
Nantes,3071,1528,1543,2937,134,95.64
Narandiba,4841,2435,2406,3935,906,81.28
Natividade da Serra,6698,3437,3261,2844,3854,42.46
Nazaré Paulista,18445,9396,9049,17810,635,96.56
Neves Paulista,8620,4252,4368,7932,688,92.02
Nhandeara,10782,5266,5516,9057,1725,84
Nipoã,4969,2594,2375,4510,459,90.76
Nova Aliança,6450,3186,3264,5635,815,87.36
Nova Campina,9675,4904,4771,7671,2004,79.29
Nova Canaã Paulista,1937,977,960,979,958,50.54
Nova Castilho,1176,573,603,938,238,79.76
Nova Europa,10749,5300,5449,10204,545,94.93
Nova Granada,20918,10503,10415,19592,1326,93.66
Nova Guataporanga,2191,1091,1100,1969,222,89.87
Nova Independência,3731,1847,1884,3172,559,85.02
Nova Luzitânia,4044,2106,1938,3782,262,93.52
Nova Odessa,58039,28687,29352,57093,946,98.37
Novais,5509,2931,2578,5137,372,93.25
Novo Horizonte,38954,19364,19590,36529,2425,93.77
Nuporanga,7268,3616,3652,6926,342,95.29
Ocauçu,4146,2095,2051,3582,564,86.4
Óleo,2527,1250,1277,1818,709,71.94
Olímpia,52516,25803,26713,50148,2368,95.49
Onda Verde,4225,2154,2071,3597,628,85.14
Oriente,6265,3048,3217,5956,309,95.07
Orindiúva,6866,3465,3401,6405,461,93.29
Orlândia,42266,20687,21579,41177,1089,97.42
Osasco,680964,327774,353190,680964,,100
Oscar Bressane,2514,1204,1310,2203,311,87.63
Osvaldo Cruz,31263,15573,15690,28537,2726,91.28
Ourinhos,110489,53580,56909,107635,2854,97.42
Ouro Verde,8268,4069,4199,7784,484,94.15
Ouroeste,9777,4832,4945,9111,666,93.19
Pacaembu,13056,7602,5454,9620,3436,73.68
Palestina,12160,6119,6041,10458,1702,86
Palmares Paulista,12997,6881,6116,12623,374,97.12
Palmeira d'Oeste,9130,4535,4595,7428,1702,81.36
Palmital,21599,10512,11087,20431,1168,94.59
Panorama,15199,7550,7649,14870,329,97.84
Paraguaçu Paulista,44180,22105,22075,40038,4142,90.62
Paraibuna,18230,9161,9069,5496,12734,30.15
Paraíso,6269,3185,3084,5706,563,91.02
Paranapanema,19962,10081,9881,17183,2779,86.08
Paranapuã,3892,1979,1913,3568,324,91.68
Parapuã,10507,5312,5195,9053,1454,86.16
Pardinho,6392,3224,3168,5657,735,88.5
Pariquera-Açu,19251,9473,9778,13610,5641,70.7
Parisi,2054,1038,1016,1719,335,83.69
Patrocínio Paulista,14463,7278,7185,12307,2156,85.09
Paulicéia,7146,3671,3475,6368,778,89.11
Paulínia,105037,51851,53186,104940,97,99.91
Paulistânia,1769,906,863,1379,390,77.95
Paulo de Faria,8521,4261,4260,7814,707,91.7
Pederneiras,45570,22709,22861,42380,3190,93
Pedra Bela,5964,3091,2873,1711,4253,28.69
Pedranópolis,2422,1243,1179,1548,874,63.91
Pedregulho,16279,8210,8069,12172,4107,74.77
Pedreira,46548,22986,23562,46157,391,99.16
Pedrinhas Paulista,3010,1489,1521,2621,389,87.08
Pedro de Toledo,10977,5471,5506,7759,3218,70.68
Penápolis,60774,29560,31214,58877,1897,96.88
Pereira Barreto,25391,12404,12987,23775,1616,93.64
Pereiras,8428,4264,4164,5628,2800,66.78
Peruíbe,66201,32104,34097,65798,403,99.39
Piacatu,5891,2946,2945,5422,469,92.04
Piedade,53536,27027,26509,25239,28297,47.14
Pilar do Sul,28221,14235,13986,23491,4730,83.24
Pindamonhangaba,163611,80289,83322,159147,4464,97.27
Pindorama,16255,8239,8016,15386,869,94.65
Pinhalzinho,14755,7340,7415,7429,7326,50.35
Piquerobi,3535,1722,1813,2818,717,79.72
Piquete,13647,6602,7045,12804,843,93.82
Piracaia,26287,12996,13291,26287,,100
Piracicaba,389873,190456,199417,382790,7083,98.18
Piraju,28574,13836,14738,26324,2250,92.13
Pirajuí,23259,12689,10570,19075,4184,82.01
Pirangi,10823,5430,5393,9951,872,91.94
Pirapora do Bom Jesus,18851,9287,9564,18851,,100
Pirapozinho,27213,13276,13937,26103,1110,95.92
Pirassununga,73706,35937,37769,69037,4669,93.67
Piratininga,13213,6514,6699,11570,1643,87.57
Pitangueiras,38584,19562,19022,37614,970,97.49
Planalto,5167,2660,2507,4585,582,88.74
Platina,3501,1805,1696,2894,607,82.66
Poá,115538,56096,59442,113713,1825,98.42
Poloni,5667,2788,2879,5044,623,89.01
Pompéia,21282,10429,10853,19954,1328,93.76
Pongaí,3351,1691,1660,2951,400,88.06
Pontal,49283,25970,23313,48784,499,98.99
Pontalinda,4487,2346,2141,3929,558,87.56
Pontes Gestal,2528,1239,1289,2249,279,88.96
Populina,3995,1990,2005,3351,644,83.88
Porangaba,9310,4712,4598,4495,4815,48.28
Porto Feliz,51697,25817,25880,45016,6681,87.08
Porto Ferreira,54102,26691,27411,53132,970,98.21
Potim,20702,11555,9147,15699,5003,75.83
Potirendaba,16605,8409,8196,15278,1327,92.01
Pracinha,2913,2094,819,1395,1518,47.89
Pradópolis,20907,10593,10314,19502,1405,93.28
Praia Grande,316844,152091,164753,316844,,100
Pratânia,5156,2651,2505,4203,953,81.52
Presidente Alves,4020,1990,2030,3537,483,87.99
Presidente Bernardes,13720,6693,7027,11480,2240,83.67
Presidente Epitácio,42400,20622,21778,39839,2561,93.96
Presidente Prudente,221073,106275,114798,216563,4510,97.96
Presidente Venceslau,38005,18945,19060,36873,1132,97.02
Promissão,39667,19617,20050,34106,5561,85.98
Quadra,3708,1924,1784,960,2748,25.89
Quatá,13935,6931,7004,13234,701,94.97
Queiroz,3279,1666,1613,2949,330,89.94
Queluz,12644,6423,6221,10370,2274,82.02
Quintana,6500,3202,3298,6009,491,92.45
Rafard,8976,4430,4546,8089,887,90.12
Rancharia,28847,14110,14737,26488,2359,91.82
Redenção da Serra,3837,1977,1860,2773,1064,72.27
Regente Feijó,19491,9614,9877,18302,1189,93.9
Reginópolis,7215,4588,2627,4298,2917,59.57
Registro,54216,26535,27681,48129,6087,88.77
Restinga,7493,3742,3751,6176,1317,82.42
Ribeira,3242,1649,1593,1483,1759,45.74
Ribeirão Bonito,12959,6486,6473,12265,694,94.64
Ribeirão Branco,17685,9056,8629,10493,7192,59.33
Ribeirão Corrente,4664,2390,2274,3860,804,82.76
Ribeirão do Sul,4360,2169,2191,3572,788,81.93
Ribeirão dos Índios,2141,1053,1088,1897,244,88.6
Ribeirão Grande,7510,3790,3720,2381,5129,31.7
Ribeirão Pires,118968,58158,60810,118968,,100
Ribeirão Preto,683777,328906,354871,681837,1940,99.72
Rifaina,3468,1731,1737,3078,390,88.75
Rincão,10496,5257,5239,8655,1841,82.46
Rinópolis,9720,4881,4839,8910,810,91.67
Rio Claro,201212,97853,103359,196819,4393,97.82
Rio das Pedras,34416,17336,17080,33676,740,97.85
Rio Grande da Serra,49816,24582,25234,49816,,100
Riolândia,11431,6418,5013,9043,2388,79.11
Riversul,5705,2796,2909,4307,1398,75.5
Rosana,18387,9038,9349,17719,668,96.37
Roseira,10642,5351,5291,10216,426,96
Rubiácea,3106,1566,1540,1871,1235,60.24
Rubinéia,2989,1463,1526,2621,368,87.69
Sabino,5468,2717,2751,4991,477,91.28
Sagres,2362,1166,1196,1989,373,84.21
Sales,6050,3041,3009,5631,419,93.07
Sales Oliveira,11518,5687,5831,10850,668,94.2
Salesópolis,16838,8411,8427,11173,5665,66.36
Salmourão,5117,2606,2511,4818,299,94.16
Saltinho,7860,3886,3974,6594,1266,83.89
Salto,115372,56888,58484,114561,811,99.3
Salto de Pirapora,44223,21883,22340,34810,9413,78.71
Salto Grande,9095,4483,4612,8380,715,92.14
Sandovalina,4211,2130,2081,3371,840,80.05
Santa Adélia,14892,7442,7450,14089,803,94.61
Santa Albertina,5672,2845,2827,5057,615,89.16
Santa Bárbara d'Oeste,188745,93233,95512,187263,1482,99.21
Santa Branca,14179,7028,7151,12507,1672,88.21
Santa Clara d'Oeste,2006,1028,978,1614,392,80.46
Santa Cruz da Conceição,4349,2136,2213,3398,951,78.13
Santa Cruz da Esperança,2077,1021,1056,1429,648,68.8
Santa Cruz das Palmeiras,33729,17048,16681,32998,731,97.83
Santa Cruz do Rio Pardo,46110,22516,23594,43274,2836,93.85
Santa Ernestina,5525,2829,2696,5316,209,96.22
Santa Fé do Sul,30804,14770,16034,29591,1213,96.06
Santa Gertrudes,26189,13197,12992,25911,278,98.94
Santa Isabel,55086,27364,27722,44716,10370,81.17
Santa Lúcia,8562,4254,4308,8208,354,95.87
Santa Maria da Serra,6141,3082,3059,5583,558,90.91
Santa Mercedes,2813,1393,1420,2572,241,91.43
Santa Rita d'Oeste,2404,1188,1216,1895,509,78.83
Santa Rita do Passa Quatro,26385,12757,13628,24263,2122,91.96
Santa Rosa de Viterbo,25604,12591,13013,24636,968,96.22
Santa Salete,1440,728,712,1031,409,71.6
Santana da Ponte Pensa,1509,760,749,1116,393,73.96
Santana de Parnaíba,138132,68057,70075,138132,,100
Santo Anastácio,20127,9781,10346,18977,1150,94.29
Santo André,693867,333318,360549,693867,,100
Santo Antônio da Alegria,6637,3391,3246,4999,1638,75.32
Santo Antônio de Posse,22849,11441,11408,21842,1007,95.59
Santo Antônio do Aracanguá,8252,4161,4091,7174,1078,86.94
Santo Antônio do Jardim,5826,2970,2856,3806,2020,65.33
Santo Antônio do Pinhal,6628,3304,3324,4631,1997,69.87
Santo Expedito,2972,1482,1490,2774,198,93.34
Santópolis do Aguapeí,4668,2351,2317,4555,113,97.58
Santos,428703,197843,230860,428382,321,99.93
São Bento do Sapucaí,10530,5258,5272,5435,5095,51.61
São Bernardo do Campo,812086,392552,419534,799027,13059,98.39
São Caetano do Sul,151244,70285,80959,151244,,100
São Carlos,242632,118836,123796,232915,9717,96
São Francisco,2677,1328,1349,2198,479,82.11
São João da Boa Vista,87340,42294,45046,85046,2294,97.37
São João das Duas Pontes,2476,1218,1258,1908,568,77.06
São João de Iracema,1850,925,925,1652,198,89.3
São João do Pau d'Alho,1985,976,1009,1716,269,86.45
São Joaquim da Barra,50274,24580,25694,49386,888,98.23
São José da Bela Vista,8727,4440,4287,7961,766,91.22
São José do Barreiro,4070,2026,2044,3217,853,79.04
São José do Rio Pardo,53206,26094,27112,49041,4165,92.17
São José do Rio Preto,447924,215795,232129,420750,27174,93.93
São José dos Campos,710654,347392,363262,696197,14457,97.97
São Lourenço da Serra,15579,7820,7759,14499,1080,93.07
São Luiz do Paraitinga,10569,5352,5217,6337,4232,59.96
São Manuel,39574,19314,20260,39042,532,98.66
São Miguel Arcanjo,32000,16172,15828,24583,7417,76.82
São Paulo,11869660,5651451,6218209,11762962,106698,99.1
São Pedro,34208,16589,17619,29769,4439,87.02
São Pedro do Turvo,7369,3736,3633,5739,1630,77.88
São Roque,87435,42753,44682,84550,2885,96.7
São Sebastião,87135,43160,43975,86153,982,98.87
São Sebastião da Grama,11936,6076,5860,8489,3447,71.12
São Simão,14847,7298,7549,13710,1137,92.34
São Vicente,357929,172235,185694,357253,676,99.81
Sarapuí,10110,5072,5038,8130,1980,80.42
Sarutaiá,3646,1832,1814,3149,497,86.37
Sebastianópolis do Sul,3293,1647,1646,2810,483,85.33
Serra Azul,12282,7337,4945,8748,3534,71.23
Serra Negra,27440,13276,14164,23897,3543,87.09
Serrana,44434,22166,22268,44183,251,99.44
Sertãozinho,122355,60606,61749,121772,583,99.52
Sete Barras,12628,6376,6252,9143,3485,72.4
Severínia,17126,8802,8324,16546,580,96.61
Silveiras,6204,3114,3090,3339,2865,53.82
Socorro,38783,19178,19605,27762,11021,71.58
Sorocaba,658547,322056,336491,651845,6702,98.98
Sud Mennucci,7713,3861,3852,6644,1069,86.14
Sumaré,283212,140074,143138,279878,3334,98.82
Suzanápolis,3947,2008,1939,2634,1313,66.73
Suzano,291002,142429,148573,280758,10244,96.48
Tabapuã,11892,5953,5939,11145,747,93.72
Tabatinga,15897,8120,7777,14361,1536,90.34
Taboão da Serra,283871,136294,147577,283871,,100
Taciba,6054,3006,3048,5320,734,87.88
Taguaí,13319,6615,6704,9542,3777,71.64
Taiaçu,6037,3010,3027,5629,408,93.24
Taiúva,6278,3594,2684,5894,384,93.88
Tambaú,22803,11283,11520,20834,1969,91.37
Tanabi,25105,12520,12585,23378,1727,93.12
Tapiraí,7699,3850,3849,5785,1914,75.14
Tapiratiba,12610,6193,6417,11298,1312,89.6
Taquaral,2751,1382,1369,2660,91,96.69
Taquaritinga,54499,26800,27699,52424,2075,96.19
Taquarituba,23193,11538,11655,21137,2056,91.14
Taquarivaí,5746,2866,2880,3337,2409,58.08
Tarabai,7269,3601,3668,6834,435,94.02
Tarumã,14806,7514,7292,14093,713,95.18
Tatuí,120123,59175,60948,116699,3424,97.15
Taubaté,307361,150507,156854,301096,6265,97.96
Tejupá,4697,2385,2312,3593,1104,76.5
Teodoro Sampaio,22414,11076,11338,18533,3881,82.68
Terra Roxa,9121,4589,4532,8779,342,96.25
Tietê,41073,20308,20765,37528,3545,91.37
Timburi,2557,1309,1248,1996,561,78.06
Torre de Pedra,2320,1206,1114,1651,669,71.16
Torrinha,9713,4847,4866,8482,1231,87.33
Trabiju,1703,841,862,1595,108,93.66
Tremembé,45978,23882,22096,42766,3212,93.01
Três Fronteiras,5547,2758,2789,4908,639,88.48
Tuiuti,6557,3296,3261,3560,2997,54.29
Tupã,62843,30304,32539,60322,2521,95.99
Tupi Paulista,14878,7686,7192,11685,3193,78.54
Turiúba,1912,979,933,1618,294,84.62
Turmalina,1805,882,923,1373,432,76.07
Ubarana,6066,3075,2991,5608,458,92.45
Ubatuba,88916,43854,45062,86842,2074,97.67
Ubirajara,4663,2397,2266,3439,1224,73.75
Uchoa,9683,4781,4902,9082,601,93.79
União Paulista,1739,899,840,1399,340,80.45
Urânia,8611,4259,4352,7504,1107,87.14
Uru,1207,611,596,1132,75,93.79
Urupês,13164,6498,6666,12090,1074,91.84
Valentim Gentil,12770,6382,6388,11859,911,92.87
Valinhos,124742,61300,63442,119288,5454,95.63
Valparaíso,23988,13051,10937,23353,635,97.35
Vargem,10000,5068,4932,6290,3710,62.9
Vargem Grande do Sul,41501,20494,21007,39933,1568,96.22
Vargem Grande Paulista,52762,26108,26654,52762,,100
Várzea Paulista,120535,59859,60676,120535,,100
Vera Cruz,10524,5146,5378,9460,1064,89.89
Vinhedo,77521,38238,39283,75085,2436,96.86
Viradouro,18347,9192,9155,17810,537,97.07
Vista Alegre do Alto,8014,4087,3927,7594,420,94.76
Vitória Brasil,1760,890,870,1562,198,88.75
Votorantim,119824,59303,60521,115254,4570,96.19
Votuporanga,91760,44664,47096,89189,2571,97.2
Zacarias,2560,1271,1289,2183,377,85.27